NO textures/bluestone.png
SO textures/greystone.png
WE textures/colorstone.png
EA textures/colorstone.png
F 128,128,128
C  0,255,255

111111111111111111111111111111111
100000000000000000000001000000001
100000000000000000000001000000001
100000000000000000000001000000001
100000000000000000000001000000001
1000000000000N0000000001000000001
100000000000000000000001011111111
100000000000000000000000000000001
100000000000000000000000000000001
111111111111111100000000000000001
100000000000000000000000000000001111
1000000000000000000000000000000010001
1000000000000000000000000000000010001
100000000000000000000000000000010001
100000000000000000000000000000001111
100000001110000000000000000000001
100000000000000000000000000000001
100000000000000000000000000000001
100000000000000000000000000000001
100000000000000000000000000000001
100000000000000000000000000000001
100000000000000000111110000000001
111111111111111111111111111111111