NO textures/bluestone.png
SO textures/bluestone.png
WE textures/bluestone.png
EA textures/bluestone.png
F 128,128,128
C  90,90,90

111111111111111111111111111111111111111111
100000000000000S00000000000000000000000001
101111111111100000011111111111111111111101
101000000001100000010000000000000000000001
101011111001111111010111111111111111111101
101000001000000001010000000000000000000001
101011101111111101011111111111111111111101
101010000000000001010000000000000000000001
101010111111111111011111111111111111111101
101010100000000000000000000000000000000001
101010111111111111111111111111111111111101
100000000000000000000000000000000000000001
101111111111111111111111111111111111111101
100000000000000000000000000000000000000001
111111111111111111111111111111111111111111
