NO textures/bluestone.png
SO textures/bluestone.png
WE textures/bluestone.png
EA textures/bluestone.png
F 128,128,128
C  128,128,128

11111111
1101001111		
1111111011
10000N0011
1111111111