NO     textures/bluestone.png


SO  textures/bluestone.png


WE   textures/bluestone.png


EA                     textures/bluestone.png



F 128,128,128
C  0,255,255

11111
11111
11N11
11111
11111