1111111111111111111111111
       10000000001111111
11111111010000001000000100000011
10111101111011111101110000000001111
10100000010000000000000000000000001
10101110101111111111100000000000001
1010100000000000000010011
1010101111111011111010011
1010000000000000000010011111111111
1011111111111111111010000000000001
1000000000000000000000000000000001
1111111111111111111111111111111111
